14 14 43 36 36 36 36 35 14 14 18 18 18 18 18 18 18 18 18 18 18 18 18 18 18 18 18 18 18 18 18 18 18 18 18 18 18 18 18 18 18 18 18 18 18 18 18 18 18 18 18 18 18 18 18 18 18 18 18 18 18 18 14 14 43 36 36 36 36 35 14
14 14 43 36 36 36 36 35 14 14 18 18 18 18 18 18 18 18 18 18 18 18 18 18 18 18 18 18 18 18 18 18 18 18 18 18 18 18 18 18 18 18 18 18 18 18 18 18 18 18 18 18 18 18 18 18 18 18 18 18 18 18 14 14 43 36 36 36 36 35 14
14 14 43 36 36 36 36 35 14 14 18 18 18 18 18 18 18 18 18 18 18 18 18 18 18 18 18 18 18 18 18 18 18 18 18 18 18 18 18 18 18 18 18 18 18 18 18 18 18 18 18 18 18 18 18 18 18 18 18 18 18 18 14 14 43 36 36 36 36 35 14
14 14 43 36 36 36 36 35 14 14 18 18 18 18 18 18 18 18 18 18 18 18 18 18 18 18 18 18 18 18 18 18 18 18 18 18 18 18 18 18 18 18 18 18 18 18 18 18 18 18 18 18 18 18 18 18 18 18 18 18 18 18 14 14 43 36 36 36 36 35 14
14 14 43 36 36 36 36 35 14 14 80 79 79 79 79 79 79 79 79 79 79 79 79 79 79 79 79 79 79 79 79 79 79 79 79 79 79 79 79 79 79 79 79 79 79 79 79 79 79 79 79 79 79 79 79 79 79 79 79 79 79 79 14 14 43 36 36 36 36 35 14
14 14 43 36 36 36 36 35 14 14 18 19 19 19 19 19 19 19 19 19 19 19 19 19 19 19 19 19 19 19 19 79 79 79 79 79 79 79 79 79 79 79 79 79 79 79 79 79 79 79 79 79 79 79 79 79 79 79 79 79 79 79 14 14 43 36 36 36 36 35 14
14 14 43 36 36 36 36 35 14 14 18 58 86 59 58 86 59 59 58 58 86 59 58 58 86 59 39 86 59 40 39 73 83 83 83 83 83 83 83 83 83 83 83 83 83 83 83 83 83 83 83 83 83 83 83 12 12 12 12 12 12 13 14 14 43 36 36 36 36 35 14
14 14 43 36 36 36 36 35 14 14 78 58 59 39 59 40 58 58 59 40 59 58 59 40 59 68 69 70 58 39 59 73 88 81 81 81 88 81 89 81 81 89 88 84 13 13 13 13 13 13 13 13 13 13 13 12 12 12 12 12 12 19 14 14 43 36 36 36 36 35 14
14 14 43 36 36 36 36 35 14 14 77 67 67 67 67 69 69 69 69 69 69 69 69 69 69 66 66 66 69 69 69 66 81 89 81 88 81 81 88 81 81 89 81 81 13 14 14 14 14 14 14 14 14 14 13 66 66 66 66 66 66 19 14 14 43 36 36 36 36 35 14
14 14 43 36 36 36 36 35 14 14 18 59 59 59 40 71 01 08 01 08 01 08 01 08 08 01 08 08 01 01 01 66 69 69 69 69 69 69 69 69 69 69 69 69 66 14 14 14 14 14 14 14 14 14 13 14 12 12 12 12 12 19 14 14 43 36 36 36 36 35 14
14 14 43 36 36 36 36 35 14 14 18 58 75 74 58 71 01 02 02 02 02 06 06 60 61 03 03 06 03 03 08 66 66 66 76 76 76 76 76 76 76 66 66 66 66 14 14 14 14 14 14 14 14 14 14 14 14 14 14 14 14 19 14 14 43 36 36 36 36 35 14
14 14 43 36 36 36 36 35 14 14 18 59 73 72 59 71 01 02 02 02 02 06 03 03 03 03 03 06 03 03 01 66 66 08 83 83 83 83 83 83 72 58 58 14 13 14 14 14 14 14 14 14 14 14 14 14 12 12 12 12 12 19 14 14 43 36 36 36 36 35 14
14 14 43 36 36 36 36 35 14 14 18 40 73 72 40 71 01 02 02 02 02 02 03 03 03 03 03 03 03 03 08 66 66 01 81 81 81 81 81 81 72 58 59 14 13 14 14 14 14 14 14 14 14 14 14 14 12 12 12 12 12 13 14 14 43 36 36 36 36 35 14
14 14 43 36 36 36 36 35 14 14 18 58 73 72 69 66 08 06 06 06 06 06 03 06 06 03 06 06 06 06 01 66 66 08 81 81 81 81 81 81 72 59 58 14 13 14 14 14 14 14 14 14 14 14 14 14 12 12 12 12 12 18 14 14 43 36 36 36 36 35 14
14 14 43 36 36 36 36 35 14 14 18 59 73 72 66 66 01 04 04 04 04 04 04 06 05 05 05 05 05 05 08 66 66 01 81 81 81 81 81 81 72 58 59 14 13 14 14 14 14 14 14 14 14 14 14 14 12 12 12 12 12 18 14 14 43 36 36 36 36 35 14
14 14 43 36 36 36 36 35 14 14 18 59 73 72 76 66 08 04 04 04 04 04 04 06 05 05 05 05 05 05 01 66 66 66 81 81 81 81 81 81 72 59 58 14 13 14 14 14 14 14 14 14 14 14 14 14 12 12 12 12 12 18 14 14 43 36 36 36 36 35 14
14 14 43 36 36 36 36 35 14 14 18 40 73 72 40 71 08 04 04 04 04 04 04 06 05 05 05 05 05 05 08 66 66 01 81 81 81 81 81 81 72 58 59 14 13 14 14 14 14 14 14 14 14 14 13 14 12 12 12 12 12 18 14 14 43 36 36 36 36 35 14
14 14 43 36 36 36 36 35 14 14 18 40 73 72 59 71 01 04 04 04 04 04 04 06 05 05 05 05 05 05 01 66 66 08 81 81 81 81 81 81 72 59 58 14 13 14 14 14 14 14 14 14 14 14 13 14 12 12 12 12 12 18 14 14 43 36 36 36 36 35 14
14 14 43 36 36 36 36 35 14 14 18 59 73 72 58 71 08 04 04 04 04 04 04 06 05 05 05 05 05 05 08 66 66 01 81 81 81 81 81 81 72 58 59 14 13 13 13 13 13 13 13 13 13 13 13 14 12 12 12 12 12 18 14 14 43 36 36 36 36 35 14
14 14 43 36 36 36 36 35 14 14 18 58 58 59 59 71 08 01 01 08 01 08 01 01 08 01 08 01 08 01 01 66 66 08 85 85 85 85 85 85 72 59 58 14 14 14 14 14 14 14 14 14 14 14 14 14 12 12 12 12 12 18 14 14 43 36 36 36 36 35 14
14 14 43 36 36 36 36 35 14 14 80 79 79 79 79 79 01 08 08 01 01 08 01 08 01 08 01 01 01 08 01 19 19 08 79 79 79 79 79 79 79 79 79 79 79 79 79 79 79 79 79 79 79 79 79 79 79 79 79 79 79 79 14 14 43 36 36 36 36 35 14
14 14 43 36 36 36 36 35 14 14 18 18 18 18 18 18 18 18 18 18 18 18 18 18 18 18 18 18 18 18 18 18 18 18 18 18 18 18 18 18 18 18 18 18 18 18 18 18 18 18 18 18 18 18 18 18 18 18 18 18 18 18 14 14 43 36 36 36 36 35 14
14 14 43 36 36 36 36 35 14 14 18 18 18 18 18 18 18 18 18 18 18 18 18 18 18 18 18 18 18 18 18 18 18 18 18 18 18 18 18 18 18 18 18 18 18 18 18 18 18 18 18 18 18 18 18 18 18 18 18 18 18 18 14 14 43 36 36 36 36 35 14
14 14 43 36 36 36 36 35 14 14 18 18 18 18 18 18 18 18 18 18 18 18 18 18 18 18 18 18 18 18 18 18 18 18 18 18 18 18 18 18 18 18 18 18 18 18 18 18 18 18 18 18 18 18 18 18 18 18 18 18 18 18 14 14 43 36 36 36 36 35 14
14 14 43 36 36 36 36 35 14 14 18 18 18 18 18 18 18 18 18 18 18 18 18 18 18 18 18 18 18 18 18 18 18 18 18 18 18 18 18 18 18 18 18 18 18 18 18 18 18 18 18 18 18 18 18 18 18 18 18 18 18 18 14 14 43 36 36 36 36 35 14
14 14 43 36 36 36 36 35 14 14 18 18 18 18 18 18 18 18 18 18 18 18 18 18 18 18 18 18 18 18 18 18 18 18 18 18 18 18 18 18 18 18 18 18 18 18 18 18 18 18 18 18 18 18 18 18 18 18 18 18 18 18 14 14 43 36 36 36 36 35 14
