36 36 36 36 35 14 14 18 19 19 19 19 19 19 19 19 19 19 19 19 19 19 19 19 19 19 19 19 18 18 18 18 18 18 18 18 18 18 18 18 18 18 18 18 18 18 18 18 18 18 18 18 18 18 18 18 18 18 18
36 36 36 36 35 14 14 18 17 17 17 17 17 17 17 17 17 17 17 17 17 17 17 17 17 17 17 17 00 07 00 00 07 00 07 00 07 00 00 00 00 00 00 00 00 00 00 00 00 00 00 00 12 12 12 12 12 12 13
36 36 36 36 35 14 14 18 17 17 17 17 17 17 17 17 17 17 17 17 17 17 17 17 17 17 17 17 00 00 00 07 00 00 07 00 07 00 00 07 00 13 13 13 13 13 13 13 13 13 13 13 12 12 12 12 12 12 19
36 36 36 36 35 14 14 14 14 14 14 14 14 14 14 14 14 14 14 14 14 14 14 14 14 14 14 14 14 00 00 07 00 07 00 00 00 00 00 00 00 13 14 14 14 14 14 14 14 14 14 13 14 14 14 14 14 14 19
36 36 36 36 35 14 14 18 17 17 17 17 14 01 08 01 08 01 08 01 08 08 01 08 08 01 01 01 14 14 14 14 14 14 14 14 14 14 14 14 14 14 14 14 14 14 14 14 14 14 14 13 14 12 12 12 12 12 19
36 36 36 36 35 14 14 18 17 07 07 17 14 01 03 03 03 32 32 06 06 06 06 05 05 05 08 08 14 14 14 14 14 14 14 14 14 14 14 14 14 14 14 14 14 14 14 14 14 14 14 14 14 14 14 14 14 14 19
36 36 36 36 35 14 14 18 17 00 00 17 14 14 03 03 03 03 03 03 03 05 05 05 05 05 05 14 14 14 08 07 07 00 00 00 07 00 17 17 14 13 14 14 14 14 14 14 14 14 14 14 14 12 12 12 12 12 19
36 36 36 36 35 14 14 18 17 00 07 17 14 01 06 02 06 06 06 06 06 06 06 06 06 05 08 08 14 14 01 07 00 00 07 00 07 00 17 17 14 13 14 14 14 14 14 14 14 14 14 14 14 12 12 12 12 12 13
36 36 36 36 35 14 14 18 17 07 07 00 14 08 31 02 34 02 33 06 05 05 05 05 05 05 01 01 14 14 08 00 07 00 07 00 00 07 17 17 14 13 14 14 14 14 14 14 14 14 14 14 14 12 12 12 12 12 18
36 36 36 36 35 14 14 18 17 00 00 00 14 01 31 02 02 02 02 06 05 05 05 05 05 05 08 08 14 14 01 00 00 07 00 07 00 07 17 17 14 13 14 14 14 14 14 14 14 14 14 14 14 12 12 12 12 12 18
36 36 36 36 35 14 14 18 17 07 00 00 14 08 22 02 28 02 02 06 05 05 05 05 05 05 01 01 14 14 14 00 00 00 07 00 07 00 17 17 14 13 14 14 14 14 14 14 14 14 14 14 14 12 12 12 12 12 18
36 36 36 36 35 14 14 18 17 07 07 17 14 08 23 02 29 02 02 06 04 04 04 04 24 25 08 08 14 14 01 00 07 07 07 07 00 07 17 17 14 13 14 14 14 14 14 14 14 14 14 13 14 12 12 12 12 12 18
36 36 36 36 35 14 14 18 17 00 07 17 14 01 02 02 02 02 02 02 04 04 04 04 26 27 01 01 14 14 08 07 00 07 00 07 07 00 17 17 14 13 14 14 14 14 14 14 14 14 14 13 14 12 12 12 12 12 18
36 36 36 36 35 14 14 18 17 07 00 17 14 08 02 02 02 02 02 06 04 04 04 04 04 04 08 08 14 14 01 00 07 07 07 00 07 07 17 17 14 13 13 13 13 13 13 13 13 13 13 13 14 12 12 12 12 12 18
36 36 36 36 35 14 14 18 17 17 17 17 14 08 01 01 01 01 08 01 01 08 01 08 01 08 01 01 14 14 08 00 07 00 07 00 07 00 17 17 14 14 14 14 14 14 14 14 14 14 14 14 14 12 12 12 12 12 18
36 36 36 36 35 14 14 18 18 18 18 18 18 01 08 08 01 01 08 01 08 01 08 01 01 01 08 19 19 19 08 18 18 18 18 18 18 18 18 18 18 18 18 18 18 18 18 18 18 18 18 18 18 18 18 18 18 18 18