14 14 43 36 36 36 36 35 14 14 78 18 18 18 18 18 01 08 01 08 01 08 01 08 08 01 08 08 01 01 01 69 69 69 69 69 69 69 69 69 69 69 87 87 87 87 87 87 87 87 87 87 87 87 87 87 87 87 87 87 87 18 14 14 43 36 36 36 36 35 14
14 14 43 36 36 36 36 35 14 14 77 76 76 76 76 76 76 76 76 76 76 76 76 76 76 76 76 76 76 76 76 76 76 76 76 76 76 76 76 76 76 76 76 76 76 76 76 76 76 76 76 76 76 76 76 76 76 76 76 76 76 18 14 14 43 36 36 36 36 35 14
14 14 43 36 36 36 36 35 14 14 18 58 59 59 58 58 59 59 58 58 59 59 58 58 58 59 59 58 59 58 59 58 83 83 83 83 83 83 83 83 83 83 83 83 83 83 83 83 83 83 83 83 83 83 83 12 12 12 12 12 12 93 14 14 43 36 36 36 36 35 14
14 14 43 36 36 36 36 35 14 14 18 86 59 86 58 86 59 86 58 86 59 86 58 86 59 86 59 86 59 86 58 86 85 85 85 85 85 85 85 85 85 85 85 85 85 85 85 85 85 85 85 85 85 85 85 12 12 12 12 12 12 93 14 14 43 36 36 36 36 35 14
14 14 43 36 36 36 36 35 14 14 80 79 79 79 79 79 79 79 79 79 79 79 79 79 79 79 79 79 79 79 79 79 79 79 79 79 79 79 79 79 79 79 79 79 79 79 79 79 79 79 79 79 79 79 79 79 79 79 79 79 79 13 14 14 43 36 36 36 36 35 14
14 14 43 36 36 36 36 35 14 14 18 19 19 19 19 19 19 19 19 19 19 19 19 19 19 19 19 19 19 19 19 19 106 107 108 19 96 97 98 19 19 19 19 19 19 19 19 19 19 19 19 19 19 19 19 19 19 19 19 19 19 13 14 14 43 36 36 36 36 35 14
14 14 43 36 36 36 36 35 14 14 18 58 86 59 58 86 59 59 58 58 86 59 58 58 86 59 59 86 59 59 59 73 83 83 83 83 103 94 104 83 83 83 83 83 83 83 83 83 83 83 83 83 83 83 83 12 12 12 12 12 12 13 14 14 43 36 36 36 36 35 14
14 14 43 36 36 36 36 35 14 14 78 58 59 58 59 59 58 58 59 58 59 58 59 58 59 68 69 70 58 58 59 73 88 81 81 81 101 94 102 81 81 89 88 84 13 13 13 13 13 13 13 13 13 13 66 12 12 12 12 12 12 93 14 14 43 36 36 36 36 35 14
14 14 43 36 36 36 36 35 14 14 77 67 67 67 67 69 69 69 69 69 69 69 69 69 69 66 66 66 69 69 69 66 81 89 81 88 99 94 100 81 81 89 81 81 13 14 14 14 14 14 14 14 14 13 66 12 12 12 12 12 12 93 14 14 43 36 36 36 36 35 14
14 14 43 36 36 36 36 35 14 14 18 59 59 59 86 71 01 08 01 08 01 08 01 08 08 01 08 08 01 01 01 66 87 87 87 87 87 87 87 87 87 87 87 87 66 14 14 14 14 14 14 14 14 14 66 66 66 66 66 66 66 95 14 14 43 36 36 36 36 35 14
14 14 43 36 36 36 36 35 14 14 18 58 75 74 58 71 01 03 03 62 06 06 06 06 05 06 05 05 05 08 08 66 66 66 66 66 66 66 66 66 66 66 66 66 66 14 14 14 14 14 14 14 14 14 66 66 66 66 66 66 66 95 14 14 43 36 36 36 36 35 14
14 14 43 36 36 36 36 35 14 14 18 59 73 72 59 71 03 03 03 03 03 03 65 05 05 05 05 05 05 05 05 66 66 08 90 90 90 90 90 90 90 58 58 71 13 14 14 14 14 14 14 14 14 14 66 12 12 12 12 12 12 93 14 14 43 36 36 36 36 35 14
14 14 43 36 36 36 36 35 14 14 18 86 73 72 86 71 01 06 63 06 06 06 06 06 06 06 05 06 06 08 08 66 66 01 81 81 81 81 88 81 72 58 59 71 13 14 14 14 14 14 14 14 14 14 66 12 12 12 12 12 105 13 14 14 43 36 36 36 36 35 14
14 14 43 36 36 36 36 35 14 14 18 58 73 72 69 66 08 02 02 02 02 33 06 05 05 05 05 46 47 48 01 66 66 08 81 88 89 88 81 81 72 59 58 71 13 14 14 14 14 14 14 14 14 14 66 12 12 12 12 12 12 18 14 14 43 36 36 36 36 35 14
14 14 43 36 36 36 36 35 14 14 18 59 73 72 66 66 01 31 02 02 02 02 06 05 05 05 05 05 50 51 08 66 66 01 81 89 89 81 89 81 72 58 59 71 13 14 14 14 14 14 14 14 14 14 66 12 12 12 12 12 12 18 14 14 43 36 36 36 36 35 14
14 14 43 36 36 36 36 35 14 14 18 59 73 72 76 66 08 22 02 28 02 41 06 05 05 05 05 05 05 52 01 66 66 91 81 81 81 89 81 81 72 59 58 71 13 14 14 14 14 14 14 14 14 13 66 12 12 12 12 12 12 18 14 14 43 36 36 36 36 35 14
14 14 43 36 36 36 36 35 14 14 18 86 73 72 86 71 08 23 02 29 02 42 06 04 04 04 04 04 04 53 08 66 66 01 81 88 89 81 88 81 72 58 59 71 13 14 14 14 14 14 14 14 14 13 66 12 12 12 12 12 12 18 14 14 43 36 36 36 36 35 14
14 14 43 36 36 36 36 35 14 14 18 86 73 72 59 71 01 02 02 02 02 02 64 04 04 04 04 04 24 25 01 66 66 08 81 88 88 81 89 81 72 59 58 71 13 14 14 14 14 14 14 14 14 13 66 12 12 12 12 12 12 18 14 14 43 36 36 36 36 35 14
14 14 43 36 36 36 36 35 14 14 18 59 73 72 58 71 08 44 45 02 02 02 06 04 04 04 04 04 26 27 08 66 66 01 81 81 81 81 81 88 72 58 59 71 13 13 13 13 13 13 13 13 13 13 66 12 12 12 12 12 12 18 14 14 43 36 36 36 36 35 14
14 14 43 36 36 36 36 35 14 14 18 58 58 59 86 71 08 01 01 08 01 08 01 01 08 01 08 01 08 01 01 66 66 08 85 85 85 85 85 85 72 59 58 71 66 66 66 66 66 66 66 66 66 66 66 12 12 12 12 12 12 18 14 14 43 36 36 36 36 35 14
14 14 43 36 36 36 36 35 14 14 80 79 79 79 79 79 01 08 08 01 01 08 01 08 01 08 01 01 01 08 01 92 92 08 79 79 79 79 79 79 79 79 79 79 79 79 79 79 79 79 79 79 79 79 79 79 79 79 79 79 79 79 14 14 43 36 36 36 36 35 14
14 14 43 36 36 36 36 35 14 14 18 14 14 14 14 66 01 08 08 01 01 08 01 08 01 08 01 01 01 08 01 18 18 18 18 18 18 18 18 18 18 18 18 18 18 18 18 18 18 18 18 18 18 18 18 18 18 18 18 18 18 18 14 14 43 36 36 36 36 35 14
14 14 43 36 36 36 36 35 14 14 18 14 14 14 14 66 08 109 109 109 109 109 06 110 110 110 110 110 110 110 08 18 18 18 18 18 18 18 18 18 18 18 18 18 18 18 18 18 18 18 18 18 18 18 18 18 18 18 18 18 18 18 14 14 43 36 36 36 36 35 14
14 14 43 36 36 36 36 35 14 14 18 14 14 14 14 66 01 109 109 109 109 109 06 110 110 110 110 110 110 110 01 18 18 18 18 18 18 18 18 18 18 18 18 18 18 18 18 18 18 18 18 18 18 18 18 18 18 18 18 18 18 18 14 14 43 36 36 36 36 35 14
14 14 43 36 36 36 36 35 14 14 18 14 14 14 14 66 01 109 109 109 109 109 06 110 110 110 110 110 110 110 08 66 66 66 66 66 66 66 66 66 66 66 66 66 66 66 66 66 66 66 66 66 66 66 66 66 66 66 66 66 66 18 14 14 43 36 36 36 36 35 14
14 14 43 36 36 36 36 35 14 14 18 18 18 18 18 18 01 08 08 01 01 08 01 08 01 08 01 01 01 08 01 18 18 18 18 18 18 18 18 18 18 18 18 18 18 18 18 18 18 18 18 18 18 18 18 18 18 18 18 18 18 18 14 14 43 36 36 36 36 35 14
