00 00 00 00 00 00 00 00 00 00 00 00 00 00 00 00
00 01 01 01 01 01 01 01 01 01 01 01 01 01 01 00
00 01 03 03 06 06 06 06 06 06 06 05 05 05 01 00
00 01 03 03 03 03 03 03 05 05 05 05 05 05 01 00
00 01 06 06 06 06 06 06 06 06 06 06 06 06 01 00
00 01 02 02 02 02 02 06 05 05 05 05 05 05 01 00
00 01 02 02 02 02 02 06 05 05 05 05 05 05 01 00
00 01 02 02 02 02 02 06 05 05 05 05 05 05 01 00
00 01 02 02 02 02 02 06 04 04 04 04 04 04 01 00
00 01 02 02 02 02 02 06 04 04 04 04 04 04 01 00
00 01 02 02 02 02 02 06 04 04 04 04 04 04 01 00
00 01 01 01 01 01 01 01 01 01 01 01 01 01 01 00