18 19 19 19 19 19 19 19 19 19 19 19 19 19 19 19 19 19 19 19 19 18 18 18 18 18 18 18 18 18 18 18 18 18 18 18 18 18 18 18 18 18 18 18 18 18 18 18 18 18 18 18
18 17 17 17 17 17 17 17 17 17 17 17 17 17 17 17 17 17 17 17 17 00 07 00 00 07 00 07 00 07 00 00 00 00 00 00 00 00 00 00 00 00 00 00 00 12 12 12 12 12 12 13
18 17 17 17 17 17 17 17 17 17 17 17 17 17 17 17 17 17 17 17 17 00 00 00 07 00 00 07 00 07 00 00 07 00 13 13 13 13 13 13 13 13 13 13 13 12 12 12 12 12 12 19
14 14 14 14 14 14 14 14 14 14 14 14 14 14 14 14 14 14 14 14 14 07 00 00 07 00 07 00 00 00 00 00 00 00 13 14 14 14 14 14 14 14 14 14 13 14 14 14 14 14 14 19
18 17 17 17 17 14 01 08 01 08 01 08 01 08 08 01 08 08 01 01 14 14 14 14 14 14 14 14 14 14 14 14 14 14 14 14 14 14 14 14 14 14 14 14 13 14 12 12 12 12 12 19
18 17 07 07 17 14 01 03 03 06 06 06 06 06 06 06 05 05 05 08 08 14 14 14 14 14 14 14 14 14 14 14 14 14 14 14 14 14 14 14 14 14 14 14 14 14 14 14 14 14 14 19
18 17 00 00 17 14 14 03 03 03 03 03 03 03 05 05 05 05 05 05 14 14 14 08 07 07 00 00 00 07 00 17 17 14 13 14 14 14 14 14 14 14 14 14 14 14 12 12 12 12 12 19
18 17 00 07 17 14 01 06 02 06 06 06 06 06 06 06 06 06 05 08 08 14 14 08 07 00 00 07 00 07 00 17 17 14 13 14 14 14 14 14 14 14 14 14 14 14 12 12 12 12 12 13
18 17 07 07 00 14 08 02 02 02 02 02 06 05 05 05 05 05 05 01 14 14 14 08 00 07 00 07 00 00 07 17 17 14 13 14 14 14 14 14 14 14 14 14 14 14 12 12 12 12 12 18
18 17 00 00 00 14 01 02 02 02 02 02 06 05 05 05 05 05 05 08 14 14 14 14 00 00 07 00 07 00 07 17 17 14 13 14 14 14 14 14 14 14 14 14 14 14 12 12 12 12 12 18
18 17 07 00 00 14 08 02 02 02 02 02 06 05 05 05 05 05 05 01 14 14 14 08 00 00 00 07 00 07 00 17 17 14 13 14 14 14 14 14 14 14 14 14 14 14 12 12 12 12 12 18
18 17 07 07 17 14 08 02 02 02 02 02 06 04 04 04 04 04 04 08 14 14 14 08 00 07 07 07 07 00 07 17 17 14 13 14 14 14 14 14 14 14 14 14 13 14 12 12 12 12 12 18
18 17 00 07 17 14 01 02 02 02 02 02 02 04 04 04 04 04 04 01 14 14 14 08 07 00 07 00 07 07 00 17 17 14 13 14 14 14 14 14 14 14 14 14 13 14 12 12 12 12 12 18
18 17 07 00 17 14 08 02 02 02 02 02 06 04 04 04 04 04 04 08 14 14 14 08 00 07 07 07 00 07 07 17 17 14 13 13 13 13 13 13 13 13 13 13 13 14 12 12 12 12 12 18
18 17 17 17 17 14 08 01 01 01 01 08 01 01 08 01 08 01 08 01 14 14 14 08 00 07 00 07 00 07 00 17 17 14 14 14 14 14 14 14 14 14 14 14 14 14 12 12 12 12 12 18
18 18 18 18 18 18 01 08 08 01 01 08 01 08 01 08 01 01 01 08 19 19 19 19 19 19 19 18 18 18 18 18 18 18 18 18 18 18 18 18 18 18 18 18 18 18 18 18 18 18 18 18