14 14 43 36 36 36 36 35 14 14 18 18 18 18 18 18 18 18 18 18 18 18 18 18 18 18 18 18 18 18 18 18 18 18 18 18 18 18 18 18 18 18 18 18 18 18 18 18 18 18 18 18 18 18 18 18 18 18 18 18 18 18 14 14 43 36 36 36 36 35 14
14 14 43 36 36 36 36 35 14 14 18 18 18 18 18 18 18 18 18 18 18 18 18 18 18 18 18 18 18 18 18 18 18 18 18 18 18 18 18 18 18 18 18 18 18 18 18 18 18 18 18 18 18 18 18 18 18 18 18 18 18 18 14 14 43 36 36 36 36 35 14
14 14 43 36 36 36 36 35 14 14 18 18 18 18 18 18 18 18 18 18 18 18 18 18 18 18 18 18 18 18 18 18 18 18 18 18 18 18 18 18 18 18 18 18 18 18 18 18 18 18 18 18 18 18 18 18 18 18 18 18 18 18 14 14 43 36 36 36 36 35 14
14 14 43 36 36 36 36 35 14 14 18 18 18 18 18 18 18 18 18 18 18 18 18 18 18 18 18 18 18 18 18 18 18 18 18 18 18 18 18 18 18 18 18 18 18 18 18 18 18 18 18 18 18 18 18 18 18 18 18 18 18 18 14 14 43 36 36 36 36 35 14
14 14 43 36 36 36 36 35 14 14 18 18 18 18 18 18 18 18 18 18 18 18 18 18 18 18 18 18 18 18 18 18 18 18 18 18 18 18 18 18 18 18 18 18 18 18 18 18 18 18 18 18 18 18 18 18 18 18 18 18 18 18 14 14 43 36 36 36 36 35 14
14 14 43 36 36 36 36 35 14 14 18 19 19 19 19 19 19 19 19 19 19 19 19 19 19 19 19 19 19 19 19 18 18 18 18 18 18 18 18 18 18 18 18 18 18 18 18 18 18 18 18 18 18 18 18 18 18 18 18 18 18 18 14 14 43 36 36 36 36 35 14
14 14 43 36 36 36 36 35 14 14 18 37 40 37 58 37 59 37 58 37 40 37 58 37 40 59 39 40 59 40 39 00 07 00 00 07 00 07 00 07 00 00 00 00 00 00 00 00 00 00 00 00 00 00 00 12 12 12 12 12 12 13 14 14 43 36 36 36 36 35 14
14 14 43 36 36 36 36 35 14 14 18 58 59 39 59 40 58 58 59 40 59 58 59 40 59 12 12 12 58 39 59 00 00 00 07 00 00 07 00 07 00 00 07 00 13 13 13 13 13 13 13 13 13 13 13 12 12 12 12 12 12 19 14 14 43 36 36 36 36 35 14
14 14 43 36 36 36 36 35 14 14 14 14 14 14 14 14 14 14 14 14 14 14 14 14 14 14 14 14 14 14 14 14 00 00 07 00 07 00 00 00 00 00 00 00 13 14 14 14 14 14 14 14 14 14 13 14 14 14 14 14 14 19 14 14 43 36 36 36 36 35 14
14 14 43 36 36 36 36 35 14 14 18 59 59 59 38 14 01 08 01 08 01 08 01 08 08 01 08 08 01 01 01 14 14 14 14 14 14 14 14 14 14 14 14 14 14 14 14 14 14 14 14 14 14 14 13 14 12 12 12 12 12 19 14 14 43 36 36 36 36 35 14
14 14 43 36 36 36 36 35 14 14 18 58 07 07 58 14 01 03 03 03 32 32 06 06 06 06 05 05 05 08 08 14 14 14 14 14 14 14 14 14 14 14 14 14 14 14 14 14 14 14 14 14 14 14 14 14 14 14 14 14 14 19 14 14 43 36 36 36 36 35 14
14 14 43 36 36 36 36 35 14 14 18 38 00 00 59 14 14 03 03 03 03 03 03 03 05 05 05 05 05 05 14 14 14 08 07 07 00 00 00 07 00 58 58 14 13 14 14 14 14 14 14 14 14 14 14 14 12 12 12 12 12 19 14 14 43 36 36 36 36 35 14
14 14 43 36 36 36 36 35 14 14 18 40 00 07 38 14 01 06 02 06 06 06 06 06 06 06 05 06 06 08 08 14 14 01 07 00 00 07 00 07 00 58 59 14 13 14 14 14 14 14 14 14 14 14 14 14 12 12 12 12 12 13 14 14 43 36 36 36 36 35 14
14 14 43 36 36 36 36 35 14 14 18 38 07 07 00 14 08 31 02 34 02 33 06 05 05 05 05 46 47 48 01 14 14 08 00 07 00 07 00 00 07 59 58 14 13 14 14 14 14 14 14 14 14 14 14 14 12 12 12 12 12 18 14 14 43 36 36 36 36 35 14
14 14 43 36 36 36 36 35 14 14 18 59 00 00 00 14 01 31 02 02 02 02 06 05 05 05 05 49 50 51 08 14 14 01 00 00 07 00 07 00 07 58 59 14 13 14 14 14 14 14 14 14 14 14 14 14 12 12 12 12 12 18 14 14 43 36 36 36 36 35 14
14 14 43 36 36 36 36 35 14 14 18 38 07 00 00 14 08 22 02 28 02 41 06 05 05 05 05 05 05 52 01 14 14 14 00 00 00 07 00 07 00 59 58 14 13 14 14 14 14 14 14 14 14 14 14 14 12 12 12 12 12 18 14 14 43 36 36 36 36 35 14
14 14 43 36 36 36 36 35 14 14 18 40 07 07 38 14 08 23 02 29 02 42 06 04 04 04 04 04 04 53 08 14 14 01 00 07 07 07 07 00 07 58 59 14 13 14 14 14 14 14 14 14 14 14 13 14 12 12 12 12 12 18 14 14 43 36 36 36 36 35 14
14 14 43 36 36 36 36 35 14 14 18 38 00 07 59 14 01 02 02 02 02 02 02 04 04 04 04 04 24 25 01 14 14 08 07 00 07 00 07 07 00 59 58 14 13 14 14 14 14 14 14 14 14 14 13 14 12 12 12 12 12 18 14 14 43 36 36 36 36 35 14
14 14 43 36 36 36 36 35 14 14 18 59 07 00 58 14 08 44 45 54 02 02 06 04 04 04 04 04 26 27 08 14 14 01 00 07 07 07 00 07 07 58 59 14 13 13 13 13 13 13 13 13 13 13 13 14 12 12 12 12 12 18 14 14 43 36 36 36 36 35 14
14 14 43 36 36 36 36 35 14 14 18 38 58 40 38 14 08 01 01 08 01 08 01 01 08 01 08 01 08 01 01 14 14 08 00 07 00 07 00 07 00 59 58 14 14 14 14 14 14 14 14 14 14 14 14 14 12 12 12 12 12 18 14 14 43 36 36 36 36 35 14
14 14 43 36 36 36 36 35 14 14 18 18 18 18 18 18 01 08 08 01 01 08 01 08 01 08 01 01 01 08 01 19 19 08 18 18 18 18 18 18 18 18 18 18 18 18 18 18 18 18 18 18 18 18 18 18 18 18 18 18 18 18 14 14 43 36 36 36 36 35 14
14 14 43 36 36 36 36 35 14 14 18 18 18 18 18 18 18 18 18 18 18 18 18 18 18 18 18 18 18 18 18 18 18 18 18 18 18 18 18 18 18 18 18 18 18 18 18 18 18 18 18 18 18 18 18 18 18 18 18 18 18 18 14 14 43 36 36 36 36 35 14
14 14 43 36 36 36 36 35 14 14 18 18 18 18 18 18 18 18 18 18 18 18 18 18 18 18 18 18 18 18 18 18 18 18 18 18 18 18 18 18 18 18 18 18 18 18 18 18 18 18 18 18 18 18 18 18 18 18 18 18 18 18 14 14 43 36 36 36 36 35 14
14 14 43 36 36 36 36 35 14 14 18 18 18 18 18 18 18 18 18 18 18 18 18 18 18 18 18 18 18 18 18 18 18 18 18 18 18 18 18 18 18 18 18 18 18 18 18 18 18 18 18 18 18 18 18 18 18 18 18 18 18 18 14 14 43 36 36 36 36 35 14
14 14 43 36 36 36 36 35 14 14 18 18 18 18 18 18 18 18 18 18 18 18 18 18 18 18 18 18 18 18 18 18 18 18 18 18 18 18 18 18 18 18 18 18 18 18 18 18 18 18 18 18 18 18 18 18 18 18 18 18 18 18 14 14 43 36 36 36 36 35 14
14 14 43 36 36 36 36 35 14 14 18 18 18 18 18 18 18 18 18 18 18 18 18 18 18 18 18 18 18 18 18 18 18 18 18 18 18 18 18 18 18 18 18 18 18 18 18 18 18 18 18 18 18 18 18 18 18 18 18 18 18 18 14 14 43 36 36 36 36 35 14
